#domain
hospital
#levelname
Conflict_v1
#colors
red: 0, 2, A
green: 1, 3, B
#initial
++++++++++++++
+  +  ++  +  +
+  +  ++  +  +
+  +1A++ 3+ A+
+0 B  ++2 B  +
+  +  ++  +  +
++++++++++++++
#goal
++++++++++++++
+  +  ++  +  +
+  +  ++  +  +
+  +  ++  +  +
+    A++    A+
+  +  ++  +  +
++++++++++++++
#end
