#domain
hospital
#levelname
Conflict_v1
#colors
blue: 0, D
pink: 1, C
cyan: 2, E
orange: 3, F
grey: 4, G
purple: 5, H
#initial
+++++++++++++++++++++++
+     ++     ++       +
+     ++     ++4    G +
+  C  ++2  E ++    H  +
+0  D ++  F  ++    5  +
+  1  ++  3  ++++++++++
+++++++++++++++++++++++
#goal
+++++++++++++++++++++++
+  C  ++  F  ++    H  +
+     ++     ++      G+
+     ++    E++       +
+    D++     ++       +
+     ++     ++++++++++
+++++++++++++++++++++++
#end
