#domain
hospital
#levelname
MAconflictT1T2T3V1
#colors
red: 0, A
green: 1, B,
blue: 2, D,
pink: 3, C,
cyan: 4, E,
orange: 5, F,
grey: 6, G,
purple: 7, H,
#initial
++++++++++++++++++++++++++++++
+     ++     ++     ++       +
+     ++     ++     ++6    G +
+  B  ++  C  ++4  E ++    H  +
+0  A ++2  D ++  F  ++    7  +
+  1  ++  3  ++  5  ++++++++++
+++++++++++++++++++++
#goal
++++++++++++++++++++++++++++++
+  B  ++  C  ++  F  ++    H  +
+     ++     ++     ++      G+
+     ++     ++    E++       +
+    A++    D++     ++       +
+     ++     ++     ++++++++++
+++++++++++++++++++++
#end
