#domain
hospital
#levelname
MAExample
#colors
red: 0, 2, A, C
green: 1, 3, B, D
#initial
++++++++++++
+      A0+ +
+ ++++++++ +
+          +
+ ++++++++ +
+ +1B      +
++++++++++++
+       2+ +
+ ++++++++C+
+          +
+D++++++++ +
+ +3       +
++++++++++++
#goal
++++++++++++
+        +A+
+ ++++++++ +
+          +
+ ++++++++ +
+B+        +
++++++++++++
+        +C+
+ ++++++++ +
+          +
+ ++++++++ +
+D+        +
++++++++++++
#end
