#domain
hospital
#levelname
Conflict_v1
#colors
red: 0, A
#initial
++++++++++++++++++++++++++++++++++++++++++++++++++++
+A0                                                +
+++ ++++++++++++++++++++++++++++++++++++++++++++++++
++++++++++++++++++++++++++++++++++++++++++++++++++++
#goal
++++++++++++++++++++++++++++++++++++++++++++++++++++
+                                                 A+
+++ ++++++++++++++++++++++++++++++++++++++++++++++++
++++++++++++++++++++++++++++++++++++++++++++++++++++
#end
