#domain
hospital
#levelname
SAKJFWAOL
#colors
red: B, A, 0, C
#initial
                ++++++++
                +      +
+++++++++++++++++ B    +
+  A   0             B +
+  A                   +
+++++++++++++++++      +
                +   C C+
                +      +
                ++++++++
#goal
                ++++++++
                + B  B +
+++++++++++++++++      +
+ A                    +
+ A                    +
+++++++++++++++++C     +
                +      +
                +C     +
                ++++++++
#end
