#domain
hospital
#levelname
MAExample
#colors
red: 0, A
green: 1, B
#initial
++++++++++++
+      A0+ +
+ ++++++++ +
+          +
+ ++++++++ +
+ +1B      +
++++++++++++
#goal
++++++++++++
+        +A+
+ ++++++++ +
+          +
+ ++++++++ +
+B+        +
++++++++++++
#end