#domain
hospital
#levelname
MAExample
#colors
red: 0, A
green: 1, B
blue: 2, C
#initial
++++++++++++
+       0+ +
+ ++++++++A+
+          +
+B++++++++1+
+ +        +
+ C   2    +
++++++++++++
#goal
++++++++++++
+        +A+
+ ++++++++ +
+          +
+ ++++++++ +
+B+        +
+   C      +
++++++++++++
#end
