#domain
hospital
#levelname
MANoName
#colors
red: 0, A, B
green: 1, C, D
blue: 2, E
#initial
+++++++++++++++++++++++
+++++2++++C          1+
+   E                B+
+++++           +++++++
+     +               +
+     +  +++       ++++
+  + D+ A+           0+
+++++++++++++++++++++++
#goal
+++++++++++++++++++++++
+++++ ++++            +
+CB                   +
+++++           +++++++
+     +             DA+
+     +  +++       ++++
+E +  +  +            +
+++++++++++++++++++++++
#end
